[[2,2,2,2,2,2,2,2,2,2,2,2,2,2,2,2,2,2,2,2,2,2,2],
 [2,1,1,1,1,1,1,1,1,1,1,1,2,2,1,1,1,1,1,1,1,1,2],
 [2,1,2,2,2,2,2,2,2,2,2,2,2,2,2,2,1,1,2,2,2,1,2],
 [2,1,1,1,1,1,1,1,1,1,1,1,2,1,1,1,1,2,2,2,1,1,2],
 [2,1,1,2,1,1,2,2,2,2,2,2,2,1,2,1,1,1,1,2,1,1,2],
 [2,1,2,2,12,2,"A",1,1,1,1,1,2,1,1,2,2,1,2,2,1,2,2],
 [2,1,2,2,1,2,1,1,1,1,1,1,2,2,2,1,2,2,1,2,2,1,2],
 [2,1,2,2,1,2,1,1,1,1,1,1,2,1,2,1,2,2,1,1,1,1,2],
 [2,1,1,2,1,2,1,1,1,1,1,1,2,1,2,1,2,2,2,2,2,1,2],
 [2,2,1,2,1,2,2,2,2,1,2,2,2,1,2,1,1,1,1,2,2,1,2],
 [2,2,1,2,1,1,1,1,2,1,1,1,2,1,1,1,2,2,1,2,1,1,2],
 [2,1,1,2,1,1,1,1,2,1,2,2,2,1,2,1,2,2,1,2,1,1,2],
 [2,2,1,2,2,2,2,2,2,1,2,2,2,1,2,2,2,2,1,2,2,1,2],
 [2,1,1,1,1,1,1,1,1,1,1,1,1,1,1,1,1,1,1,2,2,1,2],
 [2,2,2,2,1,2,2,2,2,1,2,2,2,2,2,1,2,2,2,2,2,1,2],
 [2,1,1,2,1,2,1,2,2,1,2,2,2,1,1,1,1,1,2,1,1,1,2],
 [2,1,1,2,1,2,1,2,1,1,1,1,2,1,2,2,2,2,2,2,2,1,2],
 [2,1,1,2,1,2,1,"D",1,2,1,2,1,2,2,1,1,1,2,2,2,2],
 [2,1,1,1,1,2,1,1,1,2,1,1,2,1,2,1,2,2,1,1,1,1,2],
 [2,1,1,1,1,2,1,1,1,2,1,1,2,1,1,1,2,2,2,2,2,1,2],
 [2,1,1,1,1,2,1,1,1,2,1,1,2,2,2,2,2,2,2,2,2,1,2],
 [2,1,1,1,1,2,1,1,1,2,1,1,2,2,2,1,2,2,2,1,1,1,2],
 [2,1,1,1,1,2,1,1,1,2,1,1,2,2,2,1,2,2,1,1,1,2,2],
 [2,1,1,1,1,2,1,1,1,2,1,1,2,2,2,1,1,1,1,1,1,1,2],
 [2,2,2,2,2,2,2,2,2,2,2,2,2,2,2,2,2,2,2,2,2,2,2]]