[[2,2,2,2,2,2,2,2,2],
 [2,1,1,1,1,1,1,1,2],
 [2,1,2,1,2,1,"D",2,2],
 [2,2,2,2,2,1,2,2,2],
 [2,1,1,1,1,1,1,2,2],
 [2,1,2,2,2,2,1,1,2],
 [2,1,1,1,2,2,1,2,2],
 [2,2,2,1,2,2,1,2,2],
 [2,1,1,1,2,1,1,1,2],
 [2,1,2,2,2,2,1,2,2],
 [2,1,2,2,1,2,2,2,2],
 [2,1,2,2,1,2,2,2,2],
 [2,1,2,2,1,2,2,2,2],
 [2,1,1,1,1,2,2,2,2],
 [2,2,1,2,1,1,"A",1],
 [2,2,2,2,2,2,2,2,2]]